AAAAAAAB
ACCDEEAB
ACDDDEBB
ACCDEEBB
AFFGGBBB
AFGGHHBB
AFFGHHHB
AAHHHHBB