AAAABCCDE
AFFBBBCDE
AGFFBDDDE
AGBBBBBHE
AGGGBHHHE
ABBBBBBBE
IIEEBEEEE
IIEBBBEEE
IEEEEEEEE