AABBBBBBB
AABCCCBBD
AACCECCBD
FACCECCDD
FAACECDDD
FFCCECCDD
GGCCECCDD
GHHCCCIDD
GGHHIIIDD