ABBBBBBBB
ACCDDDDDB
ACEEEEFDB
AGEEEEFDB
AGGEEEFFB
AHGGEEFIB
AHGGFFFIB
AHHGGGIIB
AAAAAAAAA