AAAAAAAAA
BBAAAACCA
DBAAAAACA
DBEFFFGCA
DBEEEGGCA
DBEHHHGCA
DBIIGGGCA
BBBIGICCC
IIIIIIIII