AAAAAAAB
ACCCDBBB
ACEEDFFF
ACEEDDDF
AGEEEEHF
AGEEEEHA
AGGGHHHA
AAAAAAAA