AAAAAABBC
AADAAAEBC
ADDDAEEEC
AADFFFECC
AAAFFFCCA
AAGFFFHAA
AGGGIHHHA
AAGAIIHAA
AAAAAAAAA