AAAAAAAA
AABBBCAA
AABCBCAA
DDCCCCEE
DFFCCGGE
DDFCCCGE
HFFHCGGE
HHHHCCEE