AAABBBBCCC
ADBBEDBDFC
ADDEEDDDFC
ADDDEGDDFF
ADADDGGDDD
AAADDDGGDD
AADDHDDGGD
ADDDHHDDDD
ADADIHHDJD
AAAIIIJJJD