AAABBBBBB
ACCCCDDDB
AECFFFDDB
AEFFFFFGB
AEFFHFFGB
AEFFFFFGB
IEEFFFGGB
IGGGGGGGB
IIBBBBBBB