AABBBCCDDD
AAABCCCDED
AAABBCCDDD
AAABCCCDFD
AABBBCCDFD
AGGGHIJIFF
AGGHHIJIFF
AGGGHIIIFF
AAAGHHIFFF
AGGGHHIFFF