AAABBBBBBB
BABBBBBBBB
BBBCDBBBBB
BBCCDDBBEB
BBBCDBFBEE
BBBBBBFFEG
BBBBBBFHGG
BBBBIBHHHG
BBJIIBBBBB
BJJJIBBBBB