AAAAAAABAA
AAAAAABBBA
AAACAAABAA
AAADDDAAAA
AAEEEEEEAA
AFFFFFFFFA
AAGGHHIIAA
JJGGHHIIJJ
JJHHHHHHHJ
JJJJJJJJJJ