AAAAAAAAA
BBBBBBBBA
BCCCCCCBA
DCEFFFCBG
DCEHHFCBG
DCEHFFCBG
ICECCCCBG
IBBBBBBBG
IIIIGGGGG