AAAAAAABB
AAACCDDBB
AAACCDDAA
AAAAEEAAA
AAFFEEAAA
AAFFAAGGA
AHHIIAGGA
AHHIIAAAA
AAAAAAAAA