AABBBBBCC
AABDDDBCC
AEEEDFFFC
AAEGDDFHC
AAEGGGFHH
AAEIIGFHA
AEEEIFFFA
AAAAIAAAA
AAAAAAAAA