AAAAAABBB
ACCCCCCCD
ACEFFFDDD
ACEEEFDDD
ACCCCCCCG
AHHHHHHCG
AHHHHIICG
ACCCCCCCG
AAAAGGGGG