AABBACCC
ADBBACCC
AEEAACCC
AEEAAAAA
AAAFFFAA
AAAFFFAA
HHAFFFGA
HHAAAAAA