AAAAAAAAB
AACCAABBB
ADDCAEEEA
AADCAAAEA
AADAAAAAA
AAAAAFAAG
AHHHAFGGG
IHAAAFFAA
IIIAAAAAA