AAAABBBB
ACCCDBDB
AACDDDDD
AACDEDED
ACCCEDEF
AGGGEHEF
AGAGEEEF
AAAGGFFF