AAAAABCCC
AAAAABBBC
AAAADEBCC
AADDDEEEC
AAFDGHECC
AFFFHHHCC
AAIFHCCCC
AIIICCCCC
AAAICCCCC