ABAAACAAAA
ABBACCCADA
ABAAAAAADA
AAAEEADDDA
FFAEEAAAAA
AFAAAAGAHA
AAAAGGGAHA
AIAAAAAAHA
AIIAJJJAHH
AIAAAJJAAA