AAAAAAAB
ACDAAAAB
ACDDAAAB
AAAAAAAB
AAEEEFFB
AAEEEFFF
AAGGEHHH
GGGGEEHH