AAAABBAAA
ACABBBACA
ACABBAACA
DCAAAAACE
DCCCCCCCE
DFFGCEEEE
DDFGCEEHH
IIGGCEHHH
IIIGCEHHH