ABBBBBBBC
AAAABDDDC
AAABBBDCC
AABBBBBCE
ABBBBBBBE
FBBGGGBBE
FBHHGIIBE
FFFHGIEEE
FEEEEEEEE