AAABBBCC
AAAABDDC
AAAABDDC
EAAAADFF
EEAAAAAF
GEHAAAAA
GGHHAAAA
GGGHHAAA