AAAAAAAAA
BBBBBBBCA
BBDBEECCC
BBDDEEFCC
BBDGGGFCC
BBHGGFFCC
BBHHIIIIC
BCCHCCCCC
BCCCCCCCC