AAAAAAAA
ABAAACCA
BBDDEECC
BBBDECCC
BFBGHCCC
FFGGHHHC
FFFFFFHC
FCCCCCCC