AAAAABBB
AACCCCBB
DCCCECCB
DCFCCCCB
DCCCCCCB
DDCCCCBB
DDGCCHBB
DGGCCHHH