AAAAAAAAA
ABBBBBBBA
ABCCCDDBA
ABCEEEDBA
ABCEEEDBA
ABFEEEFBA
AGFFFFFBH
AGGGGGBBH
AAAAIIIHH