AABBBCCCC
DABBBBBCC
DABEBBBBC
DABECCCCC
AAAEEEFFF
GGGGHEFIF
GGGHHEFFF
GGHHEEEEF
GEEEEEFFF