AAAAAAAAB
ACCCCCDDB
AECFFFFDB
AEEFGFFHB
AEBBGGFHB
AEBBBIFHB
BBBBBIHHB
BBBIIIIHB
BBBBBBBBB