AAAAAAAAA
AAAABAAAA
AACCDDAAA
ACCEEDDAA
CCEEFGDDA
CEEEFGDDD
HEEEFGGGG
HHHFFFIIG
HFFFFFFII