AAAAAABBBBB
ACCCCCCCBCC
AAACDDDCBCE
ACCCDCFCCCE
GCDDDCFFEEE
GCCCCCCCECE
GGGHHCIIICE
GCGCHCCCICE
GCGCHCJCICK
GCCCCCJCCCK
GCJJJJJKKKK