AAAAAAAAA
ABBACDDAA
BBEECFDDA
AEECCFGAA
AAACAFGGA
HAAAAFFGA
HHAIAAFGA
AHAIIAAGA
AAAAIAAAA