AAAABBBBBC
ADDDDDDDDC
EEEDFFFFDC
DDEEFDDGDC
DDDDDDGGDC
DDHHDGGDDI
DDHDDJDDDI
DDHDDJDDDI
DDHJJJDDII
DDDDDDDDDD