AAAAAAABB
AAACCCBBB
AACCDCCBB
ACCDDDCCB
ACDDDEECB
FCCDEECCB
FGCCECCHI
FGFCCCHHI
FFFFFFFII