AAAAAABBB
ACCCCCCCB
CCDCDCDCC
CDDDDDDDE
CCFDGGHEE
CFFGGHHHE
CCFIGIHIE
ICCIIIIII
IIIIIIIII