AAAABBCDDD
AAAABBCCED
AFFGGGGCED
AFFGGGGCEE
FFHGGGGCCE
HHHHGGIICI
HHHHGGIIII
HJHJGGJIJI
HJJJGGJJJI
HHJJJJJJII