AAAABBBBB
ACCADDDBB
AAAADEDBB
FFFBDEDBB
GGFBDDDBB
GGFBBBBBB
FFFBBHHHH
BBBBBHIIH
BBBBBHHHH