AAABBCCDDD
AAAABACAAD
AAAABACAAA
AAEAAAAAAA
AAEEEAAFAA
AGEHHHAFFA
AGAAHAAIFA
GGGAHAIIAA
AAAAAAIJJA
AAAAAAJJAA