AABBBCDDDDD
AAEEECCDDDD
AAAEFFFDDDD
AFFFFFFFFFD
AFFGFFFHFFD
AFGGGFHHHFD
AFFFFIFFFFD
AFJJFFFJJFD
AFFJJJJJFFD
KKFFFFFFFDD
KKKKDDDDDDD