AAAAAABB
AAAACBBD
AEEACCDD
EEFAACDA
AFFAAAAA
AFGGAAAA
AGGAAHHA
AAAAAAHH