ABBBBBBBB
AAABBBBBB
ABBBBCBBB
DDDBCCCEE
DBBBBBCEE
DBBBBBBFE
GGBBHBBFF
GBBHHIBBF
GGHHIIIIF