AAAAAAAAA
ABBBACCCA
ABBBACCCD
ABBEAACCD
AEEEEAAFF
AGGEEEHHF
AGGGEHHHF
AGGGFHHHF
AIIFFFFFF