AAAAAAAA
ABBBCCCD
ABEEEFCD
AGEHHFCD
AGFHHFCD
AGFFFFGD
AGGGGGGD
AAAGGDDD