AAAAAAAAA
AABAAACAA
BBBDDDCCC
EEBFDGCHH
HEFFDGGHH
HEFIIIGGH
HEFFIGGHH
HFFFIGHHH
HHHHHHHHH