AAAAAAAAAA
AAAABBAAAA
AAABBBBACA
AADBBBBCCE
ADDBBBBCEE
AFFFFFFFGF
AFFHHHFGGF
AFFFHFFFFF
AFIIIJJJFJ
AAIIIIIJJJ