ABBBBBCCC
AADDDBEEC
ADDDDFEEC
ADDDFFFCC
ADDGGFCCC
DDHGGCCCC
DHHHCCCCC
IIHCCCCCC
IICCCCCCC