AAAAAAAAA
ABBAAAAAA
CDDCACEEC
CDCCCCCEC
CCCFGHCCC
IFFFGHHHI
IFFFGHHII
IFFIGIHHI
IIIIIIIII