AAAAAAAAAA
ABBBCCCCCD
AEFFFGGGCD
AEFFFFGGHD
AEIFFJGJHD
AEIFIJJJHD
AEIIIIJJHD
AEIIIIJJHD
AEEEEEEHHD
AAAAADDDDD