AAAAAAAA
ABAAAAAA
ABCCCDDA
BBEEEEDA
BFEGGEDD
BFEGGEHD
BFEGGEHD
FFEEEEHH