AAABCDDD
EABBCCCD
EEEBCCCD
EEBBCCCC
CCCCCCCC
FCCCCGGH
FCCCCGHH
FFFCCGGH