AAAAABCCC
AAADBBBCC
AADDDBECC
AAADFEEEC
AAGFFFEHC
AGGGFIHHH
AAGAIIIHA
AAAAAIAAA
AAAAAAAAA