AAABCCCD
ABBBBBCD
AAABEEED
AFFFFEED
AFGDDDDD
GGGDDDDD
HGHDDDDD
HHHDDDDD