AABBBCCC
ADBBDDDC
ADDDDDDC
AEDDDDDF
EEDDDDDF
EGDDDDDF
EGDDDHDF
GGGHHHHF