AAABBBBC
AAABDDDC
ABABDDDC
BBBBEEDC
BFFGCCCC
BFFGCHHC
BFFFCHHC
CCCCCCCC