AAABBCCC
AABBDCCC
ABBDDCCC
BBDDEFCC
BDDEEFGC
HHHFFFGC
CCHHGGGC
CCCCCCCC