AAAAAAAAA
BAAAAAAAA
BAAAAACAA
BDDDDACCC
BBEDDAFFF
GBEDDAFHH
GBEIDAFFH
GBEIDAFHH
GGEIIIFFF