ABBBBBCCC
AAACCBDDC
CCCCCBDCC
CCEEEEDCC
CCEFFFGCC
CCHFGGGCC
CCHFCCCCC
CCHHCCCCI
CCCCCCIII