AAAAAABBB
AACCCCCDB
AACEEECDD
AACEFECGD
AACFFECGD
AACEEECGG
AHCCCCCIG
AHCCCCCII
HHHHHIIII