AAABBBBBB
ACABBBBBB
ACDDDBBBB
ACEEDFFFB
ACDDDGGFB
ACDHHFFFB
AADDDIIFA
AAAAAFFFA
AAAAAAAAA