AAAAABBA
ACCCBBBA
ACCCBDBA
ACCCBBBA
AAAEEAAA
AFAAAAFA
GFFFFFFH
GGGHHHHH