AAAAAAAAA
BABBBBBAB
BBBCBDBBB
BECCFDDEB
BEEFFFEEB
BBEEEEEBB
GGGEHEIII
GEEEHEEEI
GEHHHEEEI