AAAAABBBB
AACADBBEB
ACCCDDEEE
AACADDAEA
FAAAAAAAA
FFGAHAAIA
FGGGHHIII
FFGFHFFIF
FFFFFFFFF