ABACCCCC
ABADDDDC
AAADDDCC
EAEDFGGG
EAEFFGHG
EEEFFGHG
EEEEEGHG
EEEEEGHG