AABBBCCCC
AABDECCCC
AADDEFFCC
AADEEEFFC
AEEEEEEEG
AHHEEEIGG
AGHHEIIGG
GGGGEIGGG
GGGGGGGGG