AAAABBBB
ACCCCCCB
ADDCCEFB
AGDCCEFF
GGGCCEEF
HHGCCEEE
CHCCCCEC
CCCCCCCC