AAABBBCCD
AEEEEBBCD
AEFEGGGCD
AEFHGDDDD
EEFHGGGII
IHFHGHHHI
IHFHGHHHI
IHHHHHIII
IIIIIIIII