AAAAAAAAA
AABBBAACA
ABBDEECCC
ABDDFEECE
ABGFFFEEE
ABGGFEEHE
ABBIIIHHH
AIBBBIIHI
AIIIIIIII