AAAAAABBB
AAAACAAAB
AAAACDDDB
ACCCCDBBB
AAEFFDBBB
AAEFFDBBB
AEEGFDBHB
AIGGHHHHB
IIGGBBBBB