AABCCCDEEE
AFBCGCDDHE
AFBCGGGDHE
AFCCIIGDHE
AFCFIGGHHE
AFFFIHHHEE
AAAAIIIIEJ
JJJJJJJIEJ
JEEEEEEEEJ
JJJJJJJJJJ