ABBBBBCC
BBBDDDCC
BBDDDDDD
BDDDEEED
FFFFGGED
FFFFGHHH
FFFFGHHH
FFFFGHHH