AABBBBBBC
DAEEEEBBC
AAAEEEECC
FFFGGEECC
FHFFGEEEC
FHFGGGECC
FHHHHHIIC
FHHHHHHIC
HHHHHHIII