AAABBBCCCC
AAAABBBBDC
AAEEEEEDDD
FAEEEEEEDG
FFEEEEEEGG
FFEEEEEEGG
HFEEEEEEIG
HHEEEEEEIG
HHHJJIIIIJ
HHHJJJJJJJ