AAAAAAAB
AAAAAABB
AAACDABB
AAACDEBF
AACCDEBF
AGCHDDBF
GGGHDDDF
GGGHDDDF