AAAAABBCCC
AAAAABAAAC
AADAABAAAA
ADDDAAAAAE
AAFFFAAGAE
HHHFHHHGEE
HHHHHHHGGH
HHHHHIHHHH
HHHJIIHHHH
HHJJJIHHHH