AAAABCCDD
ABBBBBCCD
ABBBEBBCD
BBBBEBBCD
BFFFEEBBD
BFGFFEEBH
BBGBBBBBH
BBGBBIIIH
GGGIIIHHH