ABBBBBBBB
AACCCCCBB
ACCDCCCCB
ADDDCEECB
ACCCCECCB
AFCGCCCBB
HFFCCCBBB
HFHHCIIBB
HHHHHIIII