AAABCCCC
AADBBBBC
ADDEEEBC
CCEEFBBC
CCEFFGGC
CCECGGHC
CCCCGHHC
CCCCCCCC