AAABBCCC
ADBBBBEC
ADDDEEEC
AADFFEGC
CADFFEGC
CAHHHHGC
CAAGGGGC
CCCCCCCC