AAAAAAAA
ABBCAAAA
BBCCDEEA
FFCDDEAA
FFFFDGGA
FFFFFFGH
FFFFFFHH
FFFFFFFH