AAAAAABB
AACCCDBB
EEECDDFF
EEECDFFF
EEGGFFFF
EEGFFFFF
HHFFFFFF
HHFFFFFF