AABBCCCCDDD
AABBEEECDFD
AAGBEHECDFD
AGGBEHECDFD
AAGBEHECDDD
AAGBEEEIIII
AAGBBIIIAAA
AAIIIIAAAAJ
AAAAAAAAJJJ
AAAAAJJJJKK
AAJJJJKKKKK