AAAAABBC
AAADABBC
AAEEEECC
AAEFFECC
AAEFFEGC
AAEEEECC
AHHCCCCC
AHHCCCCC