ABBBBBBB
AABCCDBB
BACCBDDB
BBBBBBEB
BFGGBEEB
BFBGBHBB
BFBHHHBB
BBBBBBBB