AABBBBBB
ABBCDDEE
ACCCFDEE
ACFFFDDD
AAAGGGHD
DDAGHHHD
DDAAHDDD
DDDDDDDD