AAABCCCDD
EABBCCDDD
EBBFFFFED
EEBBEEEED
EEEBEGEED
EEEEEGGEE
EEEHHHGGE
EEIIIGGEE
EIIIIGEEE