AAAAAAAAA
AAAABAAAA
ABBBBBCCA
AADDBCCAA
EAADBCAAF
EEAABAAFF
GEEAAAHIF
GGEEAHHIF
GEEEEEIII