AAAAABBB
AACCCDBB
ACCEEDDB
ACEEEEFB
ACEEEEFG
ACHEEFFG
AAHHFFGG
AAAAAGGG