ABBBBBBB
ACBCDDDB
ACBCDEDB
ACCCDEDB
AFGFHHHB
AFGFHBBB
AFFFHHHB
AAAAAAAB