AAAAABBBBB
CAAABBBBBB
CDAAAEEEEB
CDDAAEFFFF
CDGHAEFFFF
CDGGEEFFFF
CDCGIEEEEF
CCCGIIIFFF
JJCGIGIIII
JJJGGGIIII