AAAAAAAA
AABCCCAD
AABEEEDD
AABEFEGG
HABEFEGH
HABEFEGH
HHBBBBHH
HHHHHHHH