AAAABBCCC
ADAABBECC
ADDDEEECC
AAAAFCCCC
AGGAFCCCC
AAGGFCHHC
AAAAFHHCC
AAAIIICCC
AAAAICCCC