AAAAABBBB
BBCCCCBBB
BBBDDDDBB
BBBBBBEEB
BBBBBBBBB
BBBFFFBBB
BBBGGGGBB
BBBBBHHHB
BBBBBBIII