ABBBBCCC
ABDDDDEC
ABDEEEEF
AADDDDFF
GGDHHHHF
GGDHGGGG
GGDDDDGG
GGGGGGGG