AAAAABBBA
ACCAABBDA
ACCCAADDA
AEFAAADDA
EEFFAAAAA
EEFFAGHHH
AIIIAGGHH
AIIAAGGAA
AAAAAAAAA