AAABCCCCD
ABBBCCDDD
AABBBDDDD
EAFFFFGDG
EEFHHFGGG
EFFFHFFFF
FFHHHHHFI
FHHHHHHHI
FFHHHHHII