AABBCCCCCC
AAABBDDCCC
CCABBEDDCC
CFFEEEDDCC
CFFEEGGCCC
CHFFGGIICC
CHHHGGJIIC
CCHHJJJIIC
CCCCJJCCCC
CCCCCCCCCC