AAAAAAAAAAA
AAABBBBBAAA
AACBDDDBBAA
ACCDDEDDBBA
ACDDDEDDDBA
AFDDDEEEDGA
AFDDDDDDDGA
AFFDDDDDHGA
IIFFDDDHHAA
IIIFJJJJAAA
IIIIIKKJAAA