AAABBBBCC
AADEEBBCC
AADDEEBCC
AADEEBBFC
AAAABBFFF
AGAAABFHF
GGGAABHHH
GIGBBBBBB
IIIBBBBBB