AAAAABBAAA
AACCABBAAA
AACCABDDAA
EACAAADDAA
EEAAAADAAA
FFAAAAAAAA
FFGHHIIAAA
FGGHHIIAJJ
AAAHAAIAJJ
AAAAAAAAAJ