AAAAAAAAA
ABBACCCDA
AABAACDDD
AABAAADEE
FABBBBBBE
FABBBBBEE
FGBBBBBEH
FGBBBBBEH
FFBIIIBHH