ABBBBBCCC
ABBBDBBBC
ABBEDDCCC
ABEEFDGCC
AEEFFFGGC
AAEHFGGIC
AAAHHHIIC
AAIIHIICC
IIIIIICCC