AAABBBAAAA
ABBBBBACCC
AAAAAAACDC
AAAEEEFCDA
AGGGHEFDDA
AAIGHFFDDA
AAIHHFFAAA
AIIHHAAAJA
AIIAAAJJJA
AAAAAAAAJA