AABBBBCC
ADBCCCCC
DDBBBBEE
DDDDFBEE
DDBBBBGG
DDDDDDDG
DHDDDHDD
HHHHHHHH