AABBBBBB
ACCCDEEB
ACFFDDEB
AAAFFDDB
GAAAFFBB
GHAAAFBB
GHHAABBA
GGGGAAAA