AAABBBBB
ACCCCBBB
ADDDCBBB
ADACCCBB
AAAACEEE
AFAACGEG
FFAACGGG
FFFFFGHG