AAAAAAAAAA
BAAACDAAAB
BBCCCDAABB
BBBBDDBBBB
BBBBBBBEEB
BBBBFFBBBB
GGBBHFBBII
GGGHHFFFFI
GHHHJJFFII
GGHJJJFIII