ABBBBBBC
AAABDCCC
EABBDCBB
BBBBDBBB
BBBBBBFB
GBBBBHFB
GBBBBHHB
GGGBBBHH