AABBCCCD
AEEBCDDD
AAEBCCCC
FFBBBCCC
FFFGHGCC
FFFGHGCC
FFFGGGCC
FFFFFGCC