AAABBBBBC
ABBBBDBBC
ABBEBDBFC
AGBEBDFFC
AFFFFFFFC
AHIIHCFFC
CHIIHCCFC
CHHHHCCCC
CCCCCCCCC