ABBBBBBB
ACDDDBBA
ACCCEEBA
AAFCEFAA
AGFFEFHA
AGFFFFHA
AGGGGHHA
AAAAAAAA