AAAAAAAAA
ABBAAAAAA
BBCCACCAA
BBCCCCCAD
BEECFCDDD
BECCCCCDG
EECCHCCGG
EIIIHGGGG
IIIHHHGGG