AAAAAAAAA
AABBAAAAA
CCCBDDEAE
FFCBBDEAE
FCCBBDEEE
FFCBBDGGE
CCCHDDDGE
GGGGGGGGG
GGGGGGGGI