AAAAABAACA
AADAAAACCA
EADAAAACAA
EAAAAAAAAA
EAAAAAFFFA
EAAGGAAAAA
AAAAGAAAHA
AIIAAAAHHH
AIIAAJAAAA
AAAAAJJJAA