AABBCCCCCC
AAABBDCCCC
EAAABDDCCF
EEAAADCCFF
CGGACCCFFF
CGGGCCHHFF
CCGCCHHHFF
CCCCIHHHHH
CCCJIIIHHH
CCJJJIIHHH