AABBBCCCC
ADDDBCBEC
AAADBBBEC
FGGDDDHEC
FGIIIDHEC
FGIHDDHEC
FGIHHHHEC
EGEEEEEEC
EEECCCCCC