AAABBBBBB
ACCCBDDDB
ACEEFGGDA
ACEFFFGDA
ACEHIIGDA
ACEHHIGDA
ACEEAGGDA
ACCCADDDA
AAAAAAAAA