AABBBBBCCC
ADDBDBDCDC
AADDDDDDDC
ADDEEFFDCC
AADGEEFDDC
ADDGHHFDCC
IIDGHHHDDJ
IDDDDDDDJJ
IDIDIDIDDJ
IIIIIIIJJJ