AAAAAAAAAA
AABBBACAAA
ADBEEECCCC
ADBBBECCCC
ADBEEEFFFC
ADBBBEFGGG
DDDEEEFFFG
DHDHIHFGGG
DHDHIHFFFG
DHHHHHJGGG