ABCCCCDDD
ABCBBBBBD
ABCBEEEBD
ABFBEBEBD
GBFBEBHBD
GBFBBBHBD
GBFFHHHBI
GBBBBBBBI
GGGIIIIII