AAAAAAAB
AAAAAACB
AAAADACB
AAAEDFCB
AAAEDFCB
AAGEDFCB
AHGEDFCB
AHGEDFCB