AAAAAAAA
ABBBAACC
ABBBDDCC
ABBBDDAA
AAAEFFAA
GGAAFFAA
GGAAAAAA
AAAHHHHA