AABBBBBC
ADDDBBBC
AAADEEEC
ADDDEFEC
GGGDEEEC
GDDDHHEC
GGGGEEEC
GGGGGCCC