AAABBCCA
ADAABBCA
ADDAABAA
AADDAAAA
AEEFFGAA
EEFFGGAA
EHFAAAAA
HHAAAAAA