AAAAAAAB
CAAAAABB
CCDAAAEB
CFDDAEEE
FFDAAAAA
AFAAGAAH
AAAGGGHH
AAAAAAAH