AAAAABCCCC
ADBBBBEEEC
ADBFFEEEEC
ADFFEEEEEC
AFFEEEEEGG
FFEEEEEFGG
FEEEEEFFHG
FEEEEFFHHG
FEEEFFHHII
FFFFFJJJII