AAAAAAAA
AABACAAA
ABBACCAA
AAADDCCA
AEEDDAAA
AAEEFGGA
AHFEFGFA
HHFFFFFF