AABBBBBB
AACCCCCB
AADDDEBB
AAFFEEEE
AAAAGGEE
AAAGGGHE
AGGGGGHE
AAHHHHHH