AABBBBBB
AAAAAAAB
CCCCCCAA
CDDDDDDE
DDEEEEEE
DEEFFFFF
FFFFFGGG
FGGGGGHH