AAABBCCCC
ACBBCCDCC
ACBCCDDCC
CCCCCDECC
FCCCCDEEE
FFCCCCCEG
FFHCCCCCG
HHHHCCCCG
IIIIICCGG