AAAAAAAAA
BAACCCAAA
BDDDCEEEA
BBBDFFFEA
BDDDFEEEA
BDGGGGGEA
BDDDGEEEA
BBBBHIIAA
BBBBHIAAA