AAAABBBB
CCCCCCCB
DDEEEECF
DCCCCECF
DCGCCECF
DCGEEECF
HCCCCCCF
HHHHHHFF