AAAAAAAA
AABBBBAA
AABBBBAC
DABBBBAC
DAAEEAAC
DDFFFFCC
DDFFFFGG
DDDHHGGG