AAAAABBB
ABBBABCB
BBDBABCB
EEBBABCB
BBBFBBCB
BGGBBCCB
BBBBCCBB
BBBCCBBH