AAAAAAABB
ACCCCCCCB
ACDDDDDCB
ACCDEDCCB
AACDEDCBB
FACDEDCGG
FFCDEDCHG
FICCCCCHG
FIIIIIHHH