ABBBCCCCCCC
ADDBBBCCCCC
ADDBBCCCCCC
AAAACCCEEEE
AFFGHHCCCEE
AFFGHHHHHHE
AFFGHHHHHHE
AFFGHHIJHHE
AFFGHHIJHHI
KFFGHHIJHHI
KKKGGIIIIII