AAAAAAAA
AAABAAAA
AABBBCAD
AAEBCCCD
AEEEFCDD
AAEFFFGD
AHHHFGGD
AAAHHHDD