AABBBCCC
DAABEEEC
DABBBBEB
DFFBBBBB
DDFFBBBB
DDFDBBGB
DDDDDGGH
DDDDDDHH