AAABBACCD
AEEEBACDD
AEBBBACCC
AEEAAAFFF
AAAAAAFAF
AAAAGAAAF
HHHAGAGAA
HIIAGGGAA
HHIAAAAAA