ABACCCCCC
ABACDDDDC
AAAEEEDDC
FFAEDDDDD
FFAEEEGGG
FFFFFEGHH
FFFEEEGGG
FFFFFFGIG
FFFFFFGGG