AAAAAAAA
AAAABCAA
DAABBCCA
DDABAACA
EDAFFAAA
EGAAFFAA
EGGAHHAA
EEGHHAAA