AABBCDDDD
AABCCCEED
AAFFCFFED
AFFFFFFFD
AFFFFFFFD
AAFFFFFDD
AAGFFFDDH
AGGGFIDDH
AAAGIIHHH