AAAAAAAAA
AABACCCAA
ABBBDCCCC
AABDDDECC
AAAADEEEC
AFFFGCECC
AHHHGCCCC
AHHHGIIIC
AAHHHCCCC