ABBBBBBBBC
ADBBBBEEFC
ADBBBBBBFC
ADBBGGGGFC
ADBBBBBBBC
ADBBBBBBBC
ABHHHHHHBC
ABBBIBBBBB
BBBBBBBBBB
JJJJJJJJJB