AAAAABCC
ADDDEBBC
ADDDEEBB
ADDFFEEG
ADFFFHGG
AFFFHHHG
FFFHHHHG
FFHHHHHG