AAAAAAAA
ABAAAACA
BBDEEFCC
GDDEEFFG
GDEEEEEG
GGGEEGGG
HGGGGGGH
HHHHHHHH