AAAAABBBB
AACBBBCDB
AECBBBCDD
EECCBCCDD
EFCCCCCDD
FFGGCHHHH
FGGGCHHHH
FIICCCHHH
IICCCCCHH