AAABBBCCCC
ADDBECCCCC
DDDBECCCCC
DEEEEEEEEC
EEEEEEFEEE
EEEEGEFEEE
EEHEGEFEEE
IEHEGGFFJE
IEHHGGFFJE
IIHHGGFFJJ