AAAABBCCDD
EAAABBCCDD
EEABBBBDDF
AEABGGGDFF
AAABBBGDFD
HAABBBBDDD
HAAIIIBDJJ
HAABIBBDJD
HAABBBBDJD
AAAABBBDDD