AAABBBBBC
DEAAFBBBC
DEEFFFBBC
DDEFFFCCC
DGFFFFFCH
GGFFFFFHH
GFFFFFFFH
FFFFIFFFF
FFIIIIIFF