AAAABBCCC
ADDDDBBBC
ADEEEEBBC
ADEFFFFBG
ADEFBBBBG
ADEFFFFBH
ADEEEEIIH
ADDDDIIHH
AAAAIIHHH