AAAAAAAB
CCCCCCBB
BBBBBBBB
BBDDDDDB
BBEBBFBB
BBEBBBBB
GBEBBBBB
GBEHHHBB