AAAAAAAABB
AAAAAAABBC
AAAAADDBCC
AAAEDDCBCC
AAEEDCCCCC
AAEEFFGCCC
AAHFFGGGCG
AAHFGGIGGG
AHHGGJIIII
HHJJJJIIII