AAABBBBB
CCAADBEE
CFDDDGEE
FFFDGGGE
FFFHHGEE
FFHHHHEE
FHHHHHHE
HHHHHHHH