AAAABCCDE
AAABBBDDE
AABBBBBDE
ABBFBGBBE
ABFFBGGBE
ABBBBBBBE
ABBHHHBBE
ABBIHHBBE
ABBIHHBBE