AAAAAAAAA
ABBBBCCAD
ABBEBECAD
ABEEEEEDD
BBEEEEEDD
FFGEEEHID
FFGGEHHID
IFFIIIIID
IIIIDDDDD