AAABCCCDD
AAABBBCCD
AEEBFGGGD
AAEFFGDDD
AAEFHGGGI
AAEFHHHGI
AEEEHGGGI
AAIIIIIII
AAAIIIIII