AABBBBCC
ABBDDBEC
BBDDDBEE
BDDDEEEE
BDDDFFFG
BBDDFBFG
HBBFFBGG
HHBBBBGG