ABBBACCCDDD
AABAACCCCED
FAAACCEEEED
FFACCEEEEED
FAAACEEGGGD
AAHAAEGGGGG
AHHHAEGGIGG
JJJJEEGIIIG
JJJEEEGGIGG
JJJEEEGGGGG
JJJEEEEGGGK