AAAAAABBB
AAAAAABCB
AAAAAACCC
AAAAAADDC
EFFFAADDD
EGHFAAAAA
EGHFAAIAA
EGHHAIIIA
EGGHAAIAA