AAAAAAAA
ABBBBBBA
ABCCCCBD
ABEFFCBD
ABEGFCBD
AHEGGGBD
AHEEEBBD
AHHHHHDD