ABCCCCCCDD
BBBCCCECDD
CBCCCCECDD
CCCCEEEEEF
CCCCCCEFFF
CCCCGGEGGF
CHCCGGGGIF
HHHGGGGIII
JHJJGGGGIG
JJJGGGGGGG