AABAAAAC
ABBBAACC
AABAADCD
AAAAEDDD
AAAEEEDD
AAFEGDDD
AFFGGDHH
FFGGHHHH