ABBCCCBBB
ABBCDCBBB
AABBDDBBB
AAABBDBBE
AAFBBDBBE
AAFBBBBEE
AFFBBBGEG
HFHBBIGGG
HHHBBIIII