AAAAAABBB
AAABBBBBB
CDDBBEEEB
CCDBFFFEB
CGDFFEEEB
GGDFHHHEB
GDDDHEEEB
GIIIIIIBB
IIIIIIBBB