AAAABBBBB
AACABDDBB
ACCEBDBBB
ACEEBDBBB
BBBBBBBBB
BBBBBFFFF
BBGBBFHHF
BGGGBFHIF
BBGBBIIIF