AAAAAAAA
ABABAAAC
DBABABAC
DBBBBBBC
DEBBBBBC
DEEBBBFC
DEEGGHFC
DEEGGHFC