ABBBBBBCD
ABBBBBBCD
ABBEBBBCD
AABEBBBCD
FFBEBBCCD
FBBEBBBDD
FBBEBBBGG
FBHEEIIIG
FBHHHHHIG