AABBCCCC
ADDBBBBC
BDEEEEBB
BBEFFFFB
BBEFGGBB
BBEFGHHB
BBBFBHBB
BBBBBBBB