AAAAAABBB
ACCAAAABB
ACCDDAAAA
ACDDDEAAA
AFFFGEEAA
AFFGGEEAA
HHHGGAAAA
AHHAAAAII
AAAAAAIII