AAAAABBC
AAADBBCC
AADDBCCC
AEEEECFC
AEEEEFFG
AEEEEAFG
AAHHAAGG
AAAAAAAG