AAABBBCC
DDAEEBCC
DAAABBBC
DDACCBCC
FFFCCCCC
GGFCCCHC
GFFFCHHC
GGFCCCHC