ABBBBBBB
ABCCCCAB
ABDEECAB
AADEEFAA
AADEEFAA
AGDGHFHA
AGGGHHHA
AAAAAAAA