ABBCCCCC
BBBBCCCC
DBBCCEEC
DDDCEEEE
DFFFFEEG
FFHHFFGG
FHHHHFFF
FFHHFFFF