ABBBCDDD
AAABCCCD
ABBBCDDD
BBEBBDFF
GGEBHDDF
GEEEHHHF
GFFFHFFF
FFFFFFFF