AABBBBBBBB
AABBBBBBBB
AACBBBBBBB
DCCCBBBBBB
DCCEEBBBBB
DCCEEFFBBB
DCCEGFFFHB
DDIIGGGFHB
DDIIGJJFHB
DDIIIJJJHH