AABBCCCCC
ABBBBBBCC
DDDEBEFFF
DGGEBEFFF
DDGEBEFHF
DGGEBEFIF
DGGEEEFIF
GGGGGGIIG
GGGGGGGGG