ABBCDAAA
ABBCDAAA
AEEEDAAA
AEEEDAFF
AAAAAAFF
AAAAAAFF
AAAAAAGG
HHHHHHGG