AAAAAAAAA
AAAABAAAA
AAAABAACA
AAABBDDCA
AAABBDDCE
AFFFGDCCE
HFGGGDCEE
HFFFGIEEI
HHHHGIIII