AABBBCCDD
AAEAACCAD
AAEAAAAAD
FAAAGGGAD
FFFAGFGAH
FIFFIFGAH
FIFFIFGAH
FIIIIFHHH
FFFFFFFFF