AAAAAAAA
ABBBCCCA
ABDDDDCA
ABDEEDCF
ABDEEGCF
FBDDGGHF
FBBBBHHF
FFFFFFFF