AAAAAAAAAA
ABBBCCCCCD
ABEEEEFGCD
ABEHHHFGCD
ABEIIHFGCD
ABEIJHFGCD
ABJJJHFGCD
AFFFFFFGCD
AGGGGGGGCD
DDDDDDDDDD