AAAABBCCCC
ADDBBEEDDC
AADDBEDDCC
FAFDGEDCCC
FFFDGEDCHC
FFIDDDDCHC
FFIDDDDCHH
JFIDDDDIIH
JFIIDDIIHH
JJIIIIIIIH