AAAAAAAB
ACDAEEEB
AADAEBEB
DDDAFBEB
DAAAFBGB
HAAAFBGB
HHHFFBGB
BBBBBBBB