AAABCDDD
AABBBBDD
AAABBEED
AAAFGEED
AAAGGEEH
AGGGGGGH
AAGGGGHH
AAAGGHHH