AAABBBCC
AABBBDDC
ABBBBDDB
EEEEBBBB
FGGEEBBB
FGGGEBBH
FFEEEBBH
FFFFEHHH