AAAAAAAA
ABBBCACD
ABEBCACD
ABEBCCCD
AFEEGHDD
AFEEGHDD
AFFFGGGD
ADDDDDDD