AAAAAAAA
ABBBBBBA
CDBBBBEF
CDDBBEEF
CCCBBEFF
GGBBBBFH
GBBBBBBH
GGGGHHHH