ABBBBBCCCC
AABBBBCDCC
AABBBBCDCC
AAEEEDDDCC
AAFFFFGDCC
AAHGGGGDCC
AAHHHHHDCC
IIIIJJIIIC
IIJJJIIICC
IIIIIIIIII