AAABBBCC
ADADBCCC
ADDDBEEE
ADDDBFFF
AADBBFDF
AADDDDDF
AGDDDDDF
GGDHHHDF