AAAAAAAA
BBCCAADA
BAACCDDA
BEAAFFDA
GEAAFFAA
GEEAAHHA
GAAAHHAA
GAAAAAAA