AABBCCBBBD
AABCCBBBDD
BBBBBBBBBD
BBBEEBBBBB
BFBBEBBGBB
FFFBEBGGBB
BBBBBBGBBB
HBBBIBBBBJ
HHBIIIBJJJ
HBBBBBBBBB