AAAAAABB
AAACDBBB
AACCDDBB
AEEEDDDB
AFFFGGGB
AHFFGGHB
HHHFGHHB
HHHHHHBB