AAAAAAABB
AACCAAABB
AACDDBBBB
EACCDFBGB
EEECDFBGB
EEECDFFGG
EEEEDDFHG
EEEEIFFHG
IIIIIHHHH