AABBBAAA
CAAAAADA
CCAAADDA
AAAEAAAA
FAEEAAAG
FAAAAAGG
FAAHHAAA
AAAHAAAA