AAABBBBB
ACACDBDB
ACCCDDDB
AAACEEDF
AGAGHEHF
AGGGHHHA
AAAGAAHA
AAAAAAAA