AAABCDDD
ABBBCDCD
AAABCDCD
CCCCCCCC
CECCCCCC
FEFCCGGG
FEFCCHHG
FFFCCGGG