AAABBCCC
BAABBCCB
BBABBCBB
DBBBBBBE
DFFEEEEE
DFGEDHEE
DFGEDHEE
DDDDDDDE