AABCCDDDD
EABBCDDDD
EABBCFFDD
AAACCCFDD
GHHIIIFDD
GGHIIFFFD
GGHIIGGGG
GHHHGGGGG
GGGGGGGGG