AAAAAABBB
AAAAAAAAC
ADDDEAAAC
AAAAEAAAC
AAAAEAAAA
AAAAAFFFA
AAAAAAGGG
AAHHHAAAA
AIIIAAAAA