AABBAAAA
CABBDDDA
CABBDDDA
CAAAAAEA
FFGGGAEA
FFAAAAEA
FFAAAAAA
HHHAAAAA