AAAAAAAAAA
AAAAAAABBA
ACCCCAAABA
DDAACEAABA
DAAAAEAFFA
DAAAAEAFAA
GAAAAEEFAA
GGGHAAAAAA
IIIHHHJJJA
IIIIIIIIJA