AAAABCCCCC
DEFFBGCHHH
DEFFBGCCGH
DEFFBGGGGH
DDFFBDHHGH
DDFFBDIHHH
DDFFDDIIHI
DDDDDIIIHI
JJJDDIIIHI
JJJDDIIIII