AABBBCCAA
AAAABBCCA
ADDAAAAAA
EEDDDAAFA
AEEEGGAFA
AHHGGIFFA
AAHHIIFAA
AAAAIAAAA
AAAAAAAAA