AAABBCCC
ADEEBBDC
ADDEEDDC
ADDDEDDF
ADDDDDDF
ADGGGGDF
HGGGGGGF
HHHHFFFF