AABBBBBBB
ACCDDDEEB
CCDDFDDEE
CDDDFDDDE
CDGGGDDDE
CDDDDDDDE
CHDDDDDIE
CHHDDDIIE
CCHHHHEEE