ABCDEEEE
ABCDFGGE
ABCDFFGE
ABCDDFFE
BBCCDDDD
BBCCCCCD
BBBBBBBB
BBBHHHHH