AAABBBBBBB
ACCCCDDDEB
ACCDDDDEEF
GCCDDHHEHF
GCDDDHHHHF
GIIDHHJJJF
GIDDHJJJJF
GIDHHJJJJF
GIHHHHJJJF
GGFFFFFFFF