AABCCBBB
ABBCBBDD
BBBBBBBD
EEBFFBBB
EBBBFBBB
EBBBBBBB
EBGGBHHB
EBBGBBHB