AAABBBCC
ADDDDBBC
ADDDDBEC
ADDDDEEC
FDDDDDDC
FDDDDDDG
FDHHHDDG
FFFHGGGG