BBBBBBBAA
BBCBBIBBA
BBCCIIIBA
BCCEIGBBA
BBEEGGGAA
BEEFHHGAA
BFFFDHHAA
BDFDDHDDA
BDDDDDDAA