AAAABBCCC
AAAABDDCC
AAAABDECC
AAAABDEEC
AAAAAAAAA
FGGGHAAAA
FGGHHAAAA
FFFIHAAAA
FIIIHAAAA