AAAAAAAAA
ABBBBBBCD
ABEEEEECD
ABEFFFECD
ADEFGFECD
ADHFGGECD
ADHEEEEID
ADHHHHIID
ADDDDDDDD