AAAAAAAAA
ABBBABBBA
ACCBABDDA
AECBABDAA
FEEBBBGGH
FEFFBHGHH
FFFFBHHHH
IFHBBBHHH
IFHHHHHHH