AAAABBBA
ACAABBBA
DDDABBBA
DDDAAAAA
DDDAAAEE
FFAAAAEE
FFAGGAHA
AAAGGAAA