AAABBBCCD
AAABCCCCC
AAABBCCCC
EAABCCCCC
FFFBBBICI
FGGGHGICI
FFGGGGICI
FGGGGGICI
FFFGGGIII