ABBBCDDDD
ABCBCDEEE
ABCCCDDEE
AFFFGGGEE
AFAFGHHHE
AAAIGGGHE
IIIIIIHHE
IIIIIIEEE
IIIIIIIII