AAAAAAAA
ABAAAABA
ABCCDDBE
ABBCDBBE
ABBBBBBE
AFFFFFFE
AAGFFHEE
AAGGHHEE