AABCCCCDDE
ABBCDDDDDE
ABCCDDDEEE
AACDDEEEEE
FAADDEEEGG
FFAAEEGGGG
FFFAAGGGHH
FFFFAAHHHI
FFFFFAAIII
FFFFFFAAJJ