ABBBBCCC
AABBDDDC
AAEEEFDC
AAEFFFDC
AAGGGHDC
AAGHHHDA
AAAADDDA
AAAAAAAA