AAABBCDDD
ABBBECCCD
ABFEECFCD
AFFFEFFFD
AFGFFFHFD
AFGFIFHFD
AFFFIFFFD
AAFAAAFDD
AAAAAAAAA