AAAAAAABB
ACCCCCCCB
DCEEEEECB
DCECCCECB
DCECFFFCB
DCCCFCCCG
DDCFFHHCG
ICCCCHCCG
IIIICHCGG