AABBBCCC
ABBBBBCC
BBBBBBBB
BDEEEEDB
BDEEFFDG
BDEEEEDG
HDEEEEDG
HDDDDDDG