AABBBCCCC
ADBDBCCCC
ADDDCCCCC
AAAEEECCC
AAAECECCC
AFFCCCCCC
GGFCHHHCC
GFFCHIHIC
GGCCCIIIC