AAAABBBB
ACCABDDB
AACCDDEB
AAAFDEEB
AAGGGGEB
AAGHHGEB
EEGGGGEB
EEEEEEEB