AAAABBCC
ADDABEEC
DDDDBEEC
DDDDDDCC
FFDDDDDD
FGDDDDDD
FGDDHDDH
FFDDHHHH