AAAABBBBB
AACDBBBBB
ACCDDDBEE
AACDBBBEE
AAABBBBBE
AFAAGHBBE
FFFGGHHHE
IFIEGHEEE
IIIEEEEEE