AAAAAAAAA
AABBBBBBA
AACCCCCBA
AACCDDCEA
AACFFDCEA
AGGGFCCEA
IHHGCCCEA
IIHGAAAAA
IIIAAAAAA