AABBBBCCC
DABBBBBBC
DABEEEBBB
DABBBEBBB
AAAEEEFFF
GGGEHHHHF
GIIEEEHFF
GIIIIIIIF
GIIIIIFFF