AAAAABBB
AAACDDBB
AACCDDDB
ACCEEDDB
AFFEEGGB
AAFFGGBB
AAAFGBBH
AAHHHHHH