ABBBBCCCCC
ADDDBCEECC
AFFDBCCEEC
AAFFBCCECC
GGGFBCCEHC
BBGBBCCEHC
BBGBBCCIHH
BBBBBCCIIH
BBBBBCJJII
BBBBBCCJJJ