AAAAAAAABB
AACDDDDBBE
ACCCDDBBEE
AACFDBBGGG
AAFFBBHHHG
AAFBBHHHHG
AABBGHHIHG
ABBGGGIIIG
BBJJGGGIGG
BJJGGGGGGG