ABBBBBBBB
ABCCCBDDB
ACCECDDFB
ACEEDDGFF
ACEHHGGGF
ACEEHHGIF
ACCECHIIF
AACCCAAII
AAAAAAAAA