AAAAAAAABB
AAAAACCDDB
AAAAEECDBB
AFFAECCDDB
AFAAEECDGG
AFFHEHAAAG
AFAHHHHAGG
AAAAAAAAAG
AIAIAAAJAJ
IIIIAAJJJJ