AAAABBBBC
DAABBEECC
DDAFFECCD
DFFFFCCDD
DFDDDDDDG
DDDHHDIGG
DDHHDDIIG
DHHDDDDII
HHDDDDDDI