AABBBBCD
AAABBDCD
AAEEDDDD
AFEDDGGG
AFFHHGGG
AFHHHHGG
AHHHHHHG
HHHHHHHH