AAAAAAAA
ABBBBBBA
CBBBBBBA
CCBBBBDA
CEBBBBDD
CEEBBFFD
CEGGGGFF
EEEHHHHF