AABBBBCC
ADDDDBCC
EDDDDBCC
EDDDDBBB
EEEDDDDF
GGHDDDDF
GGHDDDDF
GGHHFFFF