AABBBBCCC
ABBBDDDBC
BBBBBBDBC
BEBBBBDBB
BEBBBBFBB
BEEEBFFBB
BBBBGBBBH
IBBGGBBBH
IIBBBBHHH