AAAAAABBB
ACCDDDDEB
ADDDDDDEB
FDDDDDDDB
FDDDDDDDB
FDDDDDDDG
FHDDDDDDG
FHDDDDIIG
FFFFGGGGG