ABCCCCDEEE
ABBBCDDDEE
ABFGGDEEEE
AAFGGGGGEE
HAFGIIIIII
HHFGFIFIFI
HFFFFFFFFI
HFFFFFFFFJ
HHFFFFFFJJ
HHHHHHHJJJ