ABBBBBBBBB
AABAACBBBC
CAAADCCCCC
CDDDDCECFC
CCCCCCECFC
CCCCCCCCCC
CCCCCCCCCG
HCICJCGCGG
HCICJCGCGG
HIIJJGGGGG