AAAAAAAAAA
AAAAAAABBA
ACCAAADBBA
ACCAADDDAA
AAAEEEDAAA
AAAEEEFFFA
AAGEEEFFFA
AGGGHHFFFA
IIGAHHJJAA
IIAAAAAAAA