AAAABAAAA
ACCABADDA
ACCAAAEEA
AACCCFFEA
GAAAAFAAA
GGGGAFFFF
GGHGAAAFF
GHHHIIAAF
GGGGGGGAA