AAABBBBBB
ABBBBBBBB
BBCDCCCCB
BCCDCCCEB
BBCCCCCBB
BCCCCCFGG
BBCCCFFGG
HHHHHIIII
HHHHHHHII