AAABBBBB
ACCABDDB
ACAABBDB
AAAEEBBF
EEEEFFFF
EGEEFFHF
EGGEFHHF
EEEFFFFF