AAAABCCCC
ADABBBCCC
DDDEBECCC
FDEEEEEGC
FFFEHEGGG
FFEEEEEGI
FFFEFEIII
FFFFFFFII
FFFFFFFFF