AABBBCDDD
AAABCCEDA
AFAAACEAA
AFFFAEEEA
AFGAAHAAA
AAGAAHHHA
AGGGIHAAA
AAAIIIAAA
AAAAAAAAA