ABBBBCCC
AABDDDCD
ABBDDDDD
BBBDDDED
BBBBDEEE
FBBBDGGG
FFBBGGHG
FBBBBHHH