AAAAAAAAA
AAABBBAAA
CCABBBAAA
CDDBBBEAE
CCDDBEEEE
FCFDBEGHE
FFFFBIGHH
FFFFBIGGH
FFFFBIIGH