AAABBCCC
BABBBBCB
BABBDBCB
BBBDDBBB
BBDDEEBB
BBFEEGBB
BFFHEGGB
FFHHHHGG