AAABBBBCCCB
BADDDBBBCBB
BAEDFFFBCBB
BBEDBFGBBBB
BEEEBFGGGHB
BBBBBBGHHHB
BBBBBBBBBHB
BBBBIBIBBBB
BBBJIIIBBKB
BBBJIBIBBKB
BBJJJBBBKKK