AAABBBBB
ACCCBBBB
ACDDEEEB
ACDDFFEB
AGGGFFEB
AAHGGGGB
HAHHHBBB
HHHHHHHB