AAAAAAAAA
ABBCCCCDA
ACCCCCCDA
AEFGGGGDA
AEFHGHGHA
AEFHHHHHA
AEFHHHHHA
FEFHIIIIH
FFFHHHHHH