AAAAAABB
AACCAAAB
DAAAAAAB
DAAEEAAA
DDAAAAAA
AAAAAFFA
GAAAAAAA
GGGAAAHH