AABCCBBD
AABBCBDD
BBBBCBDB
BEBBBBBB
EEEBBFFB
BBBBFFBB
GBBBBBBB
GGGBHHHH