AAAAAAAAA
AABAAACDD
ABBBACCCD
AABEEECFD
AAAAEFFFD
AAGEEEHFD
AGGGIHHHD
ADGDIIHDD
ADDDDDDDD