CBBAAAAAA
CBBAADDEA
CCCAADDEA
AAAAADEEA
AAAAAAAAA
AFGGAAAAA
AFFGAAHHH
AFGGAAHIH
AAAAAAHIH