AAABBCDD
AAEBCCCD
AAEECCCD
AAFEGCDD
AFFFGGDD
AAFHHDDD
AAAHHHDD
AAAHHDDD