AABCCCDDD
AEBBFCDED
AEBFFGGED
AEEFEGEED
AAEFEGEHH
AAEEEEEHH
IAEEIEEII
IIIEIEIII
IIIIIIIII