AAAAAABBB
ACCCADDDB
ACECADFDB
ACECADFDB
ACCCADDDB
AAAAGAAAA
AHAAAAAHA
AHHAAAHHI
AAHHHHHII