AABBBBBB
ACDDDEEB
ACDFFFEB
ACDFDDEG
ACDFFDEG
HCDDDDEG
HCCEEEEG
HHGGGGGG