AAABBBBBB
CADBEBFBE
CDDBEBFBE
CCDBEFFFE
CCCBEEEEE
CGCBBBBBB
GGCCCCHHH
GIIIHCHHH
IIIHHHHHH