AAAAAAAAA
BCCCCCCCA
BCDDDDDCA
BCDEEFDCA
BCDEEFDCA
BCGFFFHIA
BIGGGHHIA
BIIIIIIIA
BBBBBBBBB