AAABBBBBC
BBBBBBBBC
BDDDBBBEC
BBBBBBBEB
BFBBBBBEB
BFBBBBBBB
GFBBBHHHB
GBBBBBBBB
GBBBBBIII