AAAAAAAA
BAAAAAAA
BCCADDAA
BBCAEDAA
BBCEEDAA
BCCCDDDF
BGGGFFFF
HHHGGFFF