AAAAAAAAAA
BBCCCCCCCC
BDDDDDDDDC
BDEEEEEEDC
FDEGGGGEDC
FDEHHHHEDC
DDEHIIHEDD
DDEHJIHEDD
EEEHIIHEEE
HHHHIIHHHH