AAAABCCDD
AEEABCCCD
AEEFFFCCD
AEFFFFFCD
AEFFGFFCD
AEFGGGFCH
AEFAGCFCH
AAAAICCCH
AAAAIIIHH