AAAABBCC
AADABBCC
AADABDCE
AADADDEE
DDDDDDEE
FFGGEEEE
FFGGEEEE
FHGEEEEE