AAAAAABBB
CDDDEAAAB
CCCDEAFFB
GDDDEHFHB
GDIIIHFHB
GDDDIHHHB
GGGGIBBHB
GGGGGBBHB
GGGBBBBBB