AAAAAAAA
AABBBBCA
AABDDBCA
AADDDBCC
AEEDBBCC
AEFFBGGC
EEFFFFGG
EEEFHFFG