AAAAAAAA
AABBCCCA
DDDBCEAA
DFDBBEAA
DDDGGEAA
DHHHGEEE
HHHHGGHH
HHHHHHHH