AAAAAAAAAB
AACAAADDBB
FACCAADBBG
FFCCHADGGG
EFFCHHHGGG
EEEHHHIIIG
EEJJJHIIGG
EEJGGGIGGG
GEEEGGGGGG
GGGGGGGGGG