AAABBBBBB
ACADDBDDB
ACCDDDDDB
EEEFGFDDB
EEEFGFBBB
EEEFFFBBB
EEEEEEHHI
EEEEEEIHI
EEEEEEIII