AAABBBBB
ABBBCCCB
AABBCCBB
ADDEEFFB
ADDEEFFB
GDHHEFBB
GGHHBBBB
GGHBBBBB