AAAAAAAAA
ABBBBAAAA
AAACCAADA
AAAACCADA
AAEEFAADA
AAAEFAADA
AAGEFAHHA
IIGGFAHAA
IIGAAAHAA