ABBBBCCC
ABBBBBBB
ABBDBBBB
BBBDDDBB
BBBEEDBB
BEEEFFBG
BBBBBFBG
HHHBFFBG