ABBBBBBBB
AABCCCBBB
ABBCDCBBB
AEBDDDFFB
AEDDDDDFB
AEEGDGFFB
AAAGDGBBB
HIIGGGBBB
HHIIIIIBB