AAAAABBBB
ACAAADDDB
ACEAFDDBB
ACEEFDBBB
GGFFFFFBG
GGGHFIIIG
GGHHFGIIG
GHHHGGGIG
GGGGGGGGG