AAABBBBB
AACCDBBB
ACCDDEEB
AACFDDEE
AAAFFFEG
AHAAFGGG
AHHAAAGA
HHAAAAAA