AABBBBCC
ABBDDBBC
ABDDDDBC
EBDDFDBC
EBBDFFBC
EEBBBFFC
EEEEEGFH
EEEGGGHH