AAAAAAAAAA
AAAABAAAAA
AAAABACAAA
AAADBECAAA
AAADBECAAA
AAFFFFFFAA
AAGGGGGGAA
AHHHHHHHHA
AIIIIIIIIA
JJJJJJJJJA