ABBBCBBD
AAABCCBD
BBBBBCBD
EEEBBBBD
EBBBBBBB
BBBBFBBG
HHBFFBGG
HHBFBBBG