AAAAABBB
ACCCCCBB
CCCCCBBB
DDEEEBBB
DFGEEBBH
DFGGEBHH
EFFEEBHH
EEEEEBBH