ABBBBBBB
AAACCBBB
DAAEEBBB
DDAEEFBB
ADAEEFFB
AAAEEGGB
AAEEEEGB
AAEHHEGG