AAAABBBC
AAABBCCC
ADDDEEEC
ADFDEGEC
ADFDEGEH
ADDDEGEH
AAAAAHHH
AAAAAAAH