AAAAABAAA
AAAAAAACA
AADAAAAAA
EAAAFAAAA
AAAAAAGAA
AAAAAAAAF
AAAAABAAA
AAAHAAAAA
AIAAAAAAA