AAAAABBB
AACCCCBB
ACCDDCCB
ACDDDDCB
ECDDDDCB
ECCDDCCF
GGCCCCFF
GHHHFFFF