AABBCCCCC
AAABCDCCC
EAABBDFFC
EEAAADFFC
EGGAAAFAA
EEGAHAAAA
EEGGHIIAA
EEEEHIIAA
EEEEEIAAA