AAAAAAAAAA
AAAABBAAAA
ACCABBADDA
ACCEEAADDA
AFFEEAGGGA
AFFAAAGGGA
HHHHAAGGGA
HHHHAIIJJA
HHHHAIIJJA
HHHHAAAAAA