AAAAAAAA
BCACDADA
BCCCDDDA
BBCEEDAA
BFCFGDGA
BFFFGGGA
BBFHHGBA
BBBBBBBA