ABBBCCCCCD
ABCCCCCCCD
ABCDDDDDDD
AEEDDDDDDD
AEFFFFFFFD
AEFFFFGGFD
AAAAAAAGHD
AAAAAAAGHD
AIJJGGGGHD
AIIJJHHHHD