ABBBBBBB
ACCCCCCB
ACDDDDCB
AEFDDDCB
AEFGDDHB
AEFGGDHB
AEEEHHHB
AAAAABBB