ABBBBBBBB
AACCCCCBB
ACCCCDCCE
ACFCCDDCE
ACCCCCCCE
ACCGGCHCE
ACCGGCCCE
AACCCCCEE
AAIIIIIII