AABBBCCC
AAABCCCC
ADDDCECC
AADFCEEG
AAFFCEGG
AAAFHHHG
AAAAAHAA
AAAAAAAA