AAAAABBBC
AAADDEEEC
AAADEEFEE
AAEEEFFFE
AAEFEFFEE
AAEFFFEEG
AAEFFFEGG
AHEEEEEIG
HHHHHHIIG