AAAABBBCC
ADAEEEBBC
ADEEFEEBC
ADEEFEEBC
DDDEEEGGC
DDHHEIIGG
DDHEEEIIG
DDHHEHHHG
DHHHHHHHG