AABBCCCCCD
ABBECCCCDD
ABEEECCFFF
BBECCCGGGF
CCECCGGGGG
CCCCGGGGHG
CCHHHHHGHH
CCHHHHHHHH
CIIIIHJJHJ
IIIIHHHJJJ