AAABBCCCCD
CAABCCCCED
CCACCCCEEE
CCCCFFCCEE
CCCFFFFCCE
GCCFFFFCCC
GGCCFFCCCC
GGGCCCCHCC
IICCCCHHHC
ICCCCJHHHH