AAAAAAAA
ABAAAACA
ABAAAACA
ABDAAECA
AADFGEAA
AAAFGAAA
AAAFGHHH
AAAFHHHH