AAAABBBBBBB
ACCCBDDDDEB
AAACFFFDDEE
ACCCFDDDDEE
ACGGFFFHHHE
ACCCIIFHJHE
AAAAFFFHJHE
AAKAAAAHJHE
AAKKKAAHHHK
AAAKKKKKKKK
AAAAAAAAKKK