AAAAABAA
AAAABBBA
CAADEEEA
CCADDEAA
CAADAAAF
AAGGGAFF
AAAGAAHF
AAAAAHHH