AAAABBBBC
AAABBDDEC
AACBBEDEC
ACCBEEEEC
CCCFEECCC
CGHFFCCCI
CGHHCCCII
CGGHCCIII
CCCCCIIII