ABBCDDDDBB
ABBCCBDBBE
AABCBBBBEE
ABBCBBBBBE
BBBBBBBBFE
GGGGBBFFFF
HGBBBBBBBB
HHBBBBIIII
HBBJBBBBIB
HJJJJBBBBB