AAAAABBCCDD
AAAAAABBCDD
AAAAAAACCED
AAAAAAAAFEE
AAAAAAAAFFE
GAAAAAAAAFF
GGGAAAAAAAA
HGGGAAAAAAA
HHIJJAAAAAA
KHIIJIAAAAA
KKKIIIAAAAA