AAAAAAAAA
AAAABAAAA
AAACDEEAA
AACCDDEAA
FFDGGDEAA
FDDGDDDHH
DDDDDDDDH
DDDDDDIDH
DDDDDDIII