AAAAABCC
CCCBBBBC
CDDDEECC
CDFGGEEC
CDFGGGEC
CCFFHHHC
CCCFHCHC
CCCCCCCC