AAAAAAAAAA
AABBBBBBBB
ACDDDEBBBB
ACBBBEBBBB
ACBBBFFFGB
ACBBBBBBGB
ACHHHHHBGB
AAAAAAIBGB
AAAAAAIBBB
AAAAJJJBBB