AAAABCCC
DDBBBBBC
DBBBBBBC
DBBBBBEE
FFBBBBEE
GFFBBBBE
GGBBBBBH
GBBBHHHH