AAAAAAAAA
ABBCCDDDD
ABBCCEEDD
ADDDDEEDD
ADFFDGGDD
ADFFDGGDD
ADDDHHIID
ADDDHHIID
ADDDDDDDD