ABCCCDDDDD
ABBCCDDDEE
ABBCCFDDDE
AABCCFDDDE
BABCCFFDDE
BBBCCGFDDE
BBBBCGGEEE
HCCCCIIEEE
HCJCCIIEEI
HHJJCIIIII