AAAAAAAB
ACCDDDAB
ACEEEDAB
ACFGEDAB
HCFGGDAB
HCFFFFAB
HCCCAAAB
HHBBBBBB