AAAABBBB
ACCCCCCB
ACCCCCCD
AAECCDDD
AAECCDDD
FAECCGHD
FAECCGHH
FFEEEGGH