AABBBBCCC
DAABBBBBC
DDABBECCC
DDFFGEECC
DFFHGGEEC
DFIHHGGCC
DDIIHHDDD
DDDIIDDDD
DDDDDDDDD