ABBBBBBB
ACCCCCCB
ACDDDDCB
ECFDGGBB
ECFFCCCB
ECFFFFCB
ECCCCCCH
EEHHHHHH