AAABBCCCCCC
DDAABCCCCCC
EDFFBCCCCCC
EDDFBCCCCCC
EEEFFCCCCCC
CCCCCCCCCCC
CCCCCCGHHHH
CCCCCCGGGHI
CCCCCCJKGKI
CCCCCCJKKKI
CCCCCCJJJII