AAAAAAAA
AAABBCCA
AABBBBCA
ABBDDBBA
BBDDDEBB
BFFDDEEB
GFFDDHEE
GGFDDHHH