ABBBBBBB
ACCBBBBB
DCEEEBBB
DDEFFFBB
DDDFGGGG
DDDFGHHH
DDHHGHHH
DHHHHHHH