ABBBBBBBBC
AABBBBBDCC
EAAFBBDDCG
EEAFFBDHCG
EEIIFBHHCG
EEEIFBHJJG
EEEIFBHJGG
EEEIIBJJGG
EEEEIBJGGG
EEEEEGGGGG