AAAAABBBBB
AAACBBCBBB
AACCBBCCBB
DACCCCCCEB
DAACCCCEEB
DDAACCFGGB
DHHICCFFGB
HHIICCFFJB
HHCCCCCCJB
HJJJJJJJJJ