AAAAABAA
CCCCABAD
AAAAABAD
AEEEABAD
AAAAAAAA
AFAGAHHH
AFAGAAAA
AAAGAAAA