AAABBBBBB
CCADDBBBB
ACAADDBBB
AAAADDDBB
EFFADDDDB
EEEEDDDGB
EHEEDDIGG
HHEDDIIGG
HEEEEEIIG