ABCCCDAE
ABBCDDAE
ABFFFDAE
AAAFAAAE
GAAAAAHE
GGHHHHHE
GGGHEEEE
GGGGGGGE