AAAAAAAA
BBCCDDEE
BFCGDFEF
FFCGDFEF
FFGGDFEF
FFFFFFEF
FHFFFFFF
FHHHHHFF