ABCCCDDDD
ABCCCCDDD
ABCBCCCCD
ABBBBCDDD
AEEBFGDDD
AAEEEGDDD
HHEEEGDGD
HHEEEGGGG
HHHHHHHGI