AAAAAABBB
AAACCCBBB
DAEEEEEBB
DAEEEEEBB
DDEEEEEBB
DDEEEEEBF
DGGEEEBBF
DGGGHFFFF
DGGGFFFII