AAAAAAAA
BCCDDEEA
BCCDDEEA
BBDDDDAA
FBGGGGAA
FGGFFGGA
FGFFHHGA
FFFFFHHA