AAAAAAAAAAA
ABABAAAAACA
BBBBBDADCCA
EBBBDDDDDCA
BBBBBDDDCCA
FBFBDDDDDCA
FFFFGDGDCCA
FFFGGGGGHIA
FFFFGGGHHIA
FJFGGGGGHII
JJJJGKGHHHH