AABBBCCC
DABBCCEC
DAABBEEE
DDFFBGEG
DDDFBGGG
DDDFFHHG
DDDDDDHG
DDDDDDHH