AABBBCCC
ADBDBECC
ADBDBCCC
ADDDBFGC
ADDDBFGG
ADHDBFGG
HDHDBFFG
HHHHGGGG