AAAAAAAAAA
BCCCCCDDDA
BCEEFFDDDA
BCEEFFDDDA
BCEGGFDDDA
BCHGGGIICA
BCHHJJIICA
BCHHJJJICA
BCCCCCCCCA
BBBBBBBBBB