ABBBBCCCCC
AABBBCCCDC
BAEEBFFDDC
BBEEBFFDCC
BBBBBCCCCC
BGGBBCCCCC
HHGGBCCIIC
HHBBBJJIIC
BBBBJJCCCC
BBBBCCCCCC