AAAAAAABBC
ADADEABBCC
ADDDAAFBBC
AFDFFFFFFC
AFFFFFCFFC
AFFFFCCCCC
FFFFFFCGCC
FHHCCFGGGC
IIHHCJGCGC
IHHCCCCCCC