AAABBBBB
ACABBBBB
ACABBBBB
ACDDDEEE
ACDDDEFE
GCDDDFFE
CCDDDFHE
CCDDDFHH