AAABBBBCCC
AADBEEFFCC
ADDDEEFFFC
GGDEEEEFFF
GEEEEEEEEF
GGEEEEEEHF
GIIEEEEHHH
GIEEIIEEHH
GIEIIJJEJH
IIIIJJJJJH